{
  "1": [
    { "x": 7, "y": 2 },
    { "x": 8, "y": 2 },
    { "x": 6, "y": 3 },
    { "x": 7, "y": 3 },
    { "x": 8, "y": 3 },
    { "x": 4, "y": 4 },
    { "x": 6, "y": 4 },
    { "x": 7, "y": 4 },
    { "x": 3, "y": 5 },
    { "x": 6, "y": 5 },
    { "x": 7, "y": 5 },
    { "x": 6, "y": 6 },
    { "x": 7, "y": 6 },
    { "x": 6, "y": 7 },
    { "x": 6, "y": 8 },
    { "x": 2, "y": 9 },
    { "x": 5, "y": 9 },
    { "x": 6, "y": 9 },
    { "x": 5, "y": 10 },
    { "x": 6, "y": 10 },
    { "x": 5, "y": 11 },
    { "x": 6, "y": 11 },
    { "x": 4, "y": 12 },
    { "x": 5, "y": 12 },
    { "x": 6, "y": 12 }
  ],
  "2": [
    { "x": 4, "y": 2 },
    { "x": 5, "y": 2 },
    { "x": 6, "y": 2 },
    { "x": 7, "y": 2 },
    { "x": 3, "y": 3 },
    { "x": 4, "y": 3 },
    { "x": 5, "y": 3 },
    { "x": 6, "y": 3 },
    { "x": 7, "y": 3 },
    { "x": 8, "y": 3 },
    { "x": 7, "y": 4 },
    { "x": 8, "y": 4 },
    { "x": 7, "y": 5 },
    { "x": 8, "y": 5 },
    { "x": 7, "y": 6 },
    { "x": 8, "y": 6 },
    { "x": 6, "y": 7 },
    { "x": 5, "y": 8 },
    { "x": 4, "y": 9 },
    { "x": 5, "y": 9 },
    { "x": 3, "y": 10 },
    { "x": 2, "y": 11 },
    { "x": 3, "y": 11 },
    { "x": 4, "y": 11 },
    { "x": 5, "y": 11 },
    { "x": 6, "y": 11 },
    { "x": 7, "y": 11 },
    { "x": 1, "y": 12 },
    { "x": 2, "y": 12 },
    { "x": 3, "y": 12 },
    { "x": 4, "y": 12 },
    { "x": 5, "y": 12 },
    { "x": 6, "y": 12 },
    { "x": 7, "y": 12 }
  ],
  "3": [
    { "x": 4, "y": 2 },
    { "x": 5, "y": 2 },
    { "x": 6, "y": 2 },
    { "x": 7, "y": 2 },
    { "x": 3, "y": 3 },
    { "x": 4, "y": 3 },
    { "x": 5, "y": 3 },
    { "x": 6, "y": 3 },
    { "x": 7, "y": 3 },
    { "x": 8, "y": 3 },
    { "x": 7, "y": 4 },
    { "x": 8, "y": 4 },
    { "x": 7, "y": 5 },
    { "x": 8, "y": 5 },
    { "x": 7, "y": 6 },
    { "x": 4, "y": 7 },
    { "x": 5, "y": 7 },
    { "x": 6, "y": 8 },
    { "x": 7, "y": 9 },
    { "x": 8, "y": 9 },
    { "x": 7, "y": 10 },
    { "x": 8, "y": 10 },
    { "x": 6, "y": 11 },
    { "x": 7, "y": 11 },
    { "x": 1, "y": 12 },
    { "x": 2, "y": 12 },
    { "x": 3, "y": 12 },
    { "x": 4, "y": 12 },
    { "x": 5, "y": 12 }
  ],
  "4": [
    { "x": 7, "y": 2 },
    { "x": 8, "y": 2 },
    { "x": 7, "y": 3 },
    { "x": 8, "y": 3 },
    { "x": 6, "y": 4 },
    { "x": 7, "y": 4 },
    { "x": 8, "y": 4 },
    { "x": 5, "y": 5 },
    { "x": 7, "y": 5 },
    { "x": 8, "y": 5 },
    { "x": 4, "y": 6 },
    { "x": 7, "y": 6 },
    { "x": 8, "y": 6 },
    { "x": 3, "y": 7 },
    { "x": 7, "y": 7 },
    { "x": 6, "y": 8 },
    { "x": 7, "y": 8 },
    { "x": 1, "y": 9 },
    { "x": 2, "y": 9 },
    { "x": 3, "y": 9 },
    { "x": 5, "y": 9 },
    { "x": 6, "y": 9 },
    { "x": 7, "y": 9 },
    { "x": 8, "y": 9 },
    { "x": 1, "y": 10 },
    { "x": 2, "y": 10 },
    { "x": 3, "y": 10 },
    { "x": 4, "y": 10 },
    { "x": 5, "y": 10 },
    { "x": 6, "y": 10 },
    { "x": 7, "y": 10 },
    { "x": 8, "y": 10 },
    { "x": 6, "y": 11 },
    { "x": 6, "y": 12 }
  ],
  "5": [
    { "x": 4, "y": 2 },
    { "x": 5, "y": 2 },
    { "x": 6, "y": 2 },
    { "x": 7, "y": 2 },
    { "x": 8, "y": 2 },
    { "x": 9, "y": 2 },
    { "x": 4, "y": 3 },
    { "x": 5, "y": 3 },
    { "x": 6, "y": 3 },
    { "x": 7, "y": 3 },
    { "x": 8, "y": 3 },
    { "x": 9, "y": 3 },
    { "x": 4, "y": 4 },
    { "x": 5, "y": 4 },
    { "x": 3, "y": 5 },
    { "x": 4, "y": 5 },
    { "x": 3, "y": 6 },
    { "x": 4, "y": 6 },
    { "x": 3, "y": 7 },
    { "x": 4, "y": 7 },
    { "x": 5, "y": 7 },
    { "x": 6, "y": 7 },
    { "x": 7, "y": 7 },
    { "x": 7, "y": 8 },
    { "x": 8, "y": 8 },
    { "x": 7, "y": 9 },
    { "x": 8, "y": 9 },
    { "x": 7, "y": 10 },
    { "x": 8, "y": 10 },
    { "x": 1, "y": 11 },
    { "x": 6, "y": 11 },
    { "x": 7, "y": 11 },
    { "x": 2, "y": 12 },
    { "x": 3, "y": 12 },
    { "x": 4, "y": 12 },
    { "x": 5, "y": 12 },
    { "x": 6, "y": 12 }
  ],
  "6": [
    { "x": 6, "y": 2 },
    { "x": 7, "y": 2 },
    { "x": 8, "y": 2 },
    { "x": 9, "y": 2 },
    { "x": 5, "y": 3 },
    { "x": 6, "y": 3 },
    { "x": 7, "y": 3 },
    { "x": 8, "y": 3 },
    { "x": 9, "y": 3 },
    { "x": 4, "y": 4 },
    { "x": 3, "y": 5 },
    { "x": 3, "y": 6 },
    { "x": 3, "y": 7 },
    { "x": 5, "y": 7 },
    { "x": 6, "y": 7 },
    { "x": 7, "y": 7 },
    { "x": 8, "y": 7 },
    { "x": 2, "y": 8 },
    { "x": 3, "y": 8 },
    { "x": 7, "y": 8 },
    { "x": 8, "y": 8 },
    { "x": 2, "y": 9 },
    { "x": 3, "y": 9 },
    { "x": 7, "y": 9 },
    { "x": 8, "y": 9 },
    { "x": 2, "y": 10 },
    { "x": 3, "y": 10 },
    { "x": 7, "y": 10 },
    { "x": 8, "y": 10 },
    { "x": 3, "y": 11 },
    { "x": 7, "y": 11 },
    { "x": 3, "y": 12 },
    { "x": 4, "y": 12 },
    { "x": 5, "y": 12 },
    { "x": 6, "y": 12 }
  ],
  "7": [
    { "x": 3, "y": 2 },
    { "x": 4, "y": 2 },
    { "x": 5, "y": 2 },
    { "x": 6, "y": 2 },
    { "x": 7, "y": 2 },
    { "x": 8, "y": 2 },
    { "x": 9, "y": 2 },
    { "x": 3, "y": 3 },
    { "x": 4, "y": 3 },
    { "x": 5, "y": 3 },
    { "x": 6, "y": 3 },
    { "x": 7, "y": 3 },
    { "x": 8, "y": 3 },
    { "x": 9, "y": 3 },
    { "x": 7, "y": 4 },
    { "x": 8, "y": 4 },
    { "x": 7, "y": 5 },
    { "x": 8, "y": 5 },
    { "x": 6, "y": 6 },
    { "x": 7, "y": 6 },
    { "x": 6, "y": 7 },
    { "x": 5, "y": 8 },
    { "x": 6, "y": 8 },
    { "x": 4, "y": 9 },
    { "x": 5, "y": 9 },
    { "x": 4, "y": 10 },
    { "x": 5, "y": 10 },
    { "x": 3, "y": 11 },
    { "x": 4, "y": 11 },
    { "x": 3, "y": 12 }
  ],
  "8": [
    { "x": 5, "y": 2 },
    { "x": 6, "y": 2 },
    { "x": 7, "y": 2 },
    { "x": 4, "y": 3 },
    { "x": 5, "y": 3 },
    { "x": 6, "y": 3 },
    { "x": 7, "y": 3 },
    { "x": 8, "y": 3 },
    { "x": 3, "y": 4 },
    { "x": 4, "y": 4 },
    { "x": 8, "y": 4 },
    { "x": 3, "y": 5 },
    { "x": 4, "y": 5 },
    { "x": 7, "y": 5 },
    { "x": 8, "y": 5 },
    { "x": 3, "y": 6 },
    { "x": 4, "y": 6 },
    { "x": 5, "y": 6 },
    { "x": 7, "y": 6 },
    { "x": 4, "y": 7 },
    { "x": 5, "y": 7 },
    { "x": 6, "y": 7 },
    { "x": 3, "y": 8 },
    { "x": 7, "y": 8 },
    { "x": 2, "y": 9 },
    { "x": 7, "y": 9 },
    { "x": 8, "y": 9 },
    { "x": 2, "y": 10 },
    { "x": 7, "y": 10 },
    { "x": 8, "y": 10 },
    { "x": 2, "y": 11 },
    { "x": 7, "y": 11 },
    { "x": 3, "y": 12 },
    { "x": 4, "y": 12 },
    { "x": 5, "y": 12 },
    { "x": 6, "y": 12 }
  ],
  "9": [
    { "x": 4, "y": 2 },
    { "x": 5, "y": 2 },
    { "x": 6, "y": 2 },
    { "x": 7, "y": 2 },
    { "x": 4, "y": 3 },
    { "x": 5, "y": 3 },
    { "x": 6, "y": 3 },
    { "x": 7, "y": 3 },
    { "x": 8, "y": 3 },
    { "x": 3, "y": 4 },
    { "x": 7, "y": 4 },
    { "x": 8, "y": 4 },
    { "x": 3, "y": 5 },
    { "x": 7, "y": 5 },
    { "x": 8, "y": 5 },
    { "x": 9, "y": 5 },
    { "x": 3, "y": 6 },
    { "x": 7, "y": 6 },
    { "x": 8, "y": 6 },
    { "x": 9, "y": 6 },
    { "x": 3, "y": 7 },
    { "x": 7, "y": 7 },
    { "x": 8, "y": 7 },
    { "x": 3, "y": 8 },
    { "x": 4, "y": 8 },
    { "x": 5, "y": 8 },
    { "x": 7, "y": 8 },
    { "x": 8, "y": 8 },
    { "x": 7, "y": 9 },
    { "x": 8, "y": 9 },
    { "x": 7, "y": 10 },
    { "x": 6, "y": 11 },
    { "x": 2, "y": 12 },
    { "x": 3, "y": 12 },
    { "x": 4, "y": 12 },
    { "x": 5, "y": 12 }
  ],
  "0": [
    { "x": 5, "y": 2 },
    { "x": 6, "y": 2 },
    { "x": 7, "y": 2 },
    { "x": 4, "y": 3 },
    { "x": 5, "y": 3 },
    { "x": 6, "y": 3 },
    { "x": 7, "y": 3 },
    { "x": 8, "y": 3 },
    { "x": 3, "y": 4 },
    { "x": 4, "y": 4 },
    { "x": 7, "y": 4 },
    { "x": 8, "y": 4 },
    { "x": 9, "y": 4 },
    { "x": 3, "y": 5 },
    { "x": 7, "y": 5 },
    { "x": 8, "y": 5 },
    { "x": 9, "y": 5 },
    { "x": 3, "y": 6 },
    { "x": 7, "y": 6 },
    { "x": 8, "y": 6 },
    { "x": 9, "y": 6 },
    { "x": 2, "y": 7 },
    { "x": 3, "y": 7 },
    { "x": 7, "y": 7 },
    { "x": 8, "y": 7 },
    { "x": 9, "y": 7 },
    { "x": 2, "y": 8 },
    { "x": 3, "y": 8 },
    { "x": 7, "y": 8 },
    { "x": 8, "y": 8 },
    { "x": 2, "y": 9 },
    { "x": 3, "y": 9 },
    { "x": 7, "y": 9 },
    { "x": 8, "y": 9 },
    { "x": 2, "y": 10 },
    { "x": 3, "y": 10 },
    { "x": 7, "y": 10 },
    { "x": 8, "y": 10 },
    { "x": 3, "y": 11 },
    { "x": 6, "y": 11 },
    { "x": 7, "y": 11 },
    { "x": 3, "y": 12 },
    { "x": 4, "y": 12 },
    { "x": 5, "y": 12 },
    { "x": 6, "y": 12 }
  ]
}
